111111111111111111
10C0001P1000000001
100000101000001111
100000000000000001
1000000C0000001001
111111111111101111
111111111111101111
1000001C1000000001
100000101000001111
100000000000000001
100000000000001001
111111111111101111
111111111111101111
100000101000000001
100000101000001111
10000000C000000001
100C00000000001001
111111111111101111
111111111111101111
100000101000000001
100C00101000001111
100000000000000001
100000000000001001
111111111111101111
100000101000000001
100000101000001111
10000000C00000E001
100000000000001001
111111111111111111