1111111111111111111111111111111111111
1000000001100000000000000000000000001
1000P11111100000000000000000000000001
1000000000000000000000000000000000E01

1000000001111110000000011000000000011
10000000001C0000011111C000000C1111111
1111111111111111111111111111111111111